abandon - v. guhana, gutererana
abdomen - n. inda
aboard - j. hafi ya
about - j. hafi, nka
abscess - n. ikibyimba
babble - v. kudedemanga
baby - j. uruhinja
baby - n. umwana
bag - n. igunira, isaho
banana - n. imineke, igitoki
calamity -n. icyago
calf - n. inyana
camp - n. ingando
carve - v. gukeba
clean - j. mwiza, cyiza
dairy - n. ikaragiro
dance - v. guhamiriza
darkness - n. umwijima
dead - j. pfuye
deadline - n. ikibaliro
earth - n. isi, igitaka
earthquake - n. igishyitsi
egg - n. igi
embrace - v. guhobera
enough - j. birahagije
fable - n. umugani
feel - v. kumva
fire - n. umuriro
flee - v. guhunga
foot - n. ikirenge
game - n. umukino
gaze - v. kurangamira
gazelle - n. ingeragere
generous - j. ugira ubuntu
give - v. guha, kugaba, gutanga
habit - n. ingeso
harvest - n. umwero
hate - v. kwanga 
haze - n. igihu
hemorrhage - n. kuva amaraso
ice - n. amazi akonje cyane
idle - j. ubudeshyi, umushabizi
idol - n. ikigirwamana
imitate - v. kwigana
incapable - j. umuswa, igishema
jar - n. inkongoro
jealous - v. gufuha
jesus - n. Yesu, Yezu
journal - n. ikinyamateka
july - n. Nyakanga, ukwezi kwa karindwi
kidney - n. impyiko
king - n. umwami
knit - v. kuboha
knowledge - n. ubuhanga, ubwenge, ubumenyi
known - v. kumenyekana

 